01100000000110
00xxxxxxxxxx00
00000222200000
00xxxxxxxxxx00
00000100100000
000000xx000000
00000000000000
00000000000000
00000000000000
00000000000000
00000000000000
00000000000000
00000000000000
00000000000000
00000000000000
00000000000000
00000000000000
00000000000000