10000011000001
00000000000000
00001111110000
01100000000110
00001111110000
00000000000000
10000011000001
000000xx000000
00000000000000
00000000000000
00000000000000
00000000000000
00000000000000
00000000000000
00000000000000
00000000000000
00000000000000
00000000000000