00000000000000
00000000000000
00000000000000
00001000010000
00010100101000
00100011000100
01000000000010
10000000000001
00000000000000
00000000000000
00000000000000
00000000000000
00000000000000
00000000000000
00000000000000
00000000000000
00000000000000
00000000000000